ohne Vokals
Need You - F.O.O.L
Tell Me - Killercats, Alex Skrindo
An Eternity - Soar, Ben Walter
Fugitive - Case&Point
Error Code - Case&Point
Atlas - Feint
Combine - Bustre
Roots - Tobu
Blueshift - Catas, Kasger
Bow and Arrow - T-Mass
Aperture - Siren
Ghosts - Malik Bash
Let's Go! - Lensko
Supersonic - Rob Gasser
Never Lost - Snareskin, Holly
Reminisce - A Himitsu
Beyond the Void - Arkana
Genesis Original Mix - Arkana
Showdown - F.O.O.L
Under Water - Fareoh
Dimensions - Last Hero
Homebound - Feint
Dreams - Lost Sky
The Phantom (feat. High Maintenance) - MUZZ
Lonesong - Feint
H.A.Y - Clarx
Quantum Sonata - FormantX
Dun Kno - Focality
Monologue - Splasher!
New World - Kira
Starbound - Itro, Valcos
Arabian Nights - RudeLies, Facading
Blue - Au5, Fractal
Melophonic - Notaker
Let's Roll - Ephixa, Going Quantum
Neon Melancholy - Animadrop 
Olympus - 32 Stitches
Flight - Tristam, Braken
Children of Hell - MUZZ

Wenig Vokals
Boundless - Aero Chord
Nova - Ramses B
Try This - Pegboard Nerds
Ultimate Riot - Voicians
VIP- bvd kult
Elysium - Lostboy, Slashtaq
Ark - Ship Wrek, Zookeepers
Aura - Soulero
The Saint - Conro
To Far Gone - Inukshuk
Truth and Malice - Intercom
Dino - Mountkid
Shiawase - Dion Timmer
All Night - Stonebank
Dont Fight it - Melano
Calling Out - MUZZ, Skyelle, KG
Drakkar - Distrion, Electro-Light
Gone & Found - Sum Wave
Quantum Virtual Riot Remix - Astronaut, Virtual Riot
Humanity - Max Brhon



Interessant
Fatal Fight - Shockwave-Sound

Zum Testen mit Vokal
Bonedry - Tristam
Perfect 10 - Unknown Brain, Heather Sommer
Frame of Mind - Tristam, Braken

credo revolution mal schauen
Faul - MYRNE, Grant
Lost - ka
Afraid of the Dark - KUURO